111111111111111111111111
1P0000000000000000000001
1000CC00CC000C000CC00001
1000C0C0C0C0C0C0C0000001
1000CC00CC00C0C00CC00001
1000C0C0C0C0C0C0000C0001
1000CC00C0C00C000CC0E001
100000000000000000000001
111111111111111111111111