111111111111111111111111
1000000000000P0000000001
100011001100010001100001
100010101010101010000001
10001100110C101001100001
100010101010101000010001
100011001010010001100001
1000000000000000000000E1
111111111111111111111111