111111
1000C1
100MM1
100001
1P0CE1
111111