1111111111111111
1E00000010001CC1
1000000010001001
1111100010001001
1000000010111001
1000000010000001
1000000010000001
1000100010000001
1000100000111111
1000100000100001
1000100110100001
1000100110101001
1000000000101001
1000000000001001
10000000000010P1
1111111111111111